9 6
X XXXXXXX
X X     X
X XXX X  
X XXX X X
X     X  
XXXXXXXXX